S,.,.,.,.
W,.,.,.,L
.,.,W,.,.
.,W,.,L,T
.,.,.,.,G
