S,W,W,W,.,T,.,.,L,.,T,.,.,W,.,.,.,L,.,W,.,.,L,W,.
.,.,L,.,L,W,.,.,.,.,.,.,W,.,.,.,T,.,T,.,W,.,.,.,T
.,W,.,.,W,W,.,.,.,.,.,L,.,T,.,.,.,.,.,.,T,.,W,W,.
.,.,L,.,T,.,.,.,.,.,.,.,.,W,.,.,W,W,.,.,T,.,.,.,.
.,.,.,.,T,W,.,.,.,.,.,W,.,.,W,L,.,L,W,T,T,L,.,.,L
W,.,.,.,.,.,W,L,.,W,W,.,W,.,.,.,.,.,.,.,.,W,.,L,.
T,T,.,.,.,.,W,.,L,.,.,L,L,.,.,T,.,.,.,W,.,L,W,.,.
.,.,L,.,W,.,L,.,.,.,.,.,.,.,.,.,.,W,.,.,.,.,.,.,.
.,W,.,L,.,L,.,W,.,L,.,.,.,.,.,.,.,L,.,.,.,.,.,T,.
.,.,.,.,W,.,T,.,.,L,.,L,.,.,.,.,L,W,.,.,.,.,.,.,.
.,.,.,.,T,L,T,W,.,.,W,L,.,W,L,.,W,.,.,.,.,.,.,.,.
W,.,.,.,.,.,T,.,.,T,.,.,.,L,.,.,.,.,W,.,W,L,.,.,.
.,.,.,.,.,.,.,.,L,.,.,.,.,.,.,.,.,.,W,W,.,W,L,.,.
.,.,.,.,.,.,W,.,.,L,.,.,.,.,.,.,.,.,.,W,.,.,.,T,T
.,.,.,.,.,.,W,L,.,.,W,.,L,.,T,.,.,.,W,.,.,L,.,.,.
W,.,.,.,.,W,.,W,L,.,.,L,L,.,.,.,.,.,.,.,.,.,.,.,T
.,L,.,W,.,.,.,.,.,W,W,T,.,.,.,.,.,.,W,.,.,.,.,.,W
L,.,.,.,.,.,L,L,.,.,.,.,.,T,.,L,.,.,.,.,L,W,L,.,.
.,.,W,.,.,.,W,.,.,.,.,.,.,.,.,W,.,.,.,L,.,.,.,.,.
W,.,.,.,.,.,.,.,.,.,L,.,W,.,W,W,L,.,.,L,W,.,.,.,T
.,.,.,.,.,L,.,W,W,W,.,.,.,.,.,W,L,L,.,W,.,.,W,.,W
.,W,W,.,W,W,.,.,.,L,.,.,.,.,W,.,.,.,W,T,.,.,.,.,.
.,.,W,.,.,.,.,.,.,.,.,L,.,.,.,.,W,.,W,W,.,W,.,.,W
.,.,.,.,L,L,.,.,.,.,.,L,L,.,.,.,.,.,W,.,T,.,.,.,L
.,.,.,.,.,W,.,.,.,.,.,.,L,.,W,.,W,T,.,.,.,W,.,W,G
